#######................#######
#.......############.#.#.#...#
#.#####............#.#.#...#.#
#.....####.#######.#.#.#####.#
#.#.#....#.#.......#.#.......#
##########.#.#####.#.#######.#
#..........#.#...#.#.#.....#.#
#.##########.#.#.#.#.#.#####.#
#.#.#........###.#.#.#.#.....#
#.#.##########.#.#.#.###.#####
#.#######..........#........##
#......#..##########.######.##
#.####.#####......##.#....#.##
#.#..#.#...#.####.##.####.#.##
#.#.##.#.###.#@...##......#.##
#.#..#.#.....##############.##
#.##.#.#####.###............##
#....#.......###.###.####.####
####################.#.##.##.#
#...............####.#.#####.#
#.###.####.####.####.#.......#
#.#.#.#..#.####........#######
#.#.#.####.##############....#
#.#.#.##.#####.#####.####.##.#
#.#.#.##.##...............##.#
#...#.....#.##########.##.####
#.#########.##.........##.####
#...........##.#######..#.####
##############.##########.####
###............##*...........#
#################.############