..........
.#........
..........
.....#....
....@....#
#........
..........
....#.....
..........
..........