..........
.#........
...@......
.....#....
.........#
#.........
..........
....#.....
..........
..........